13,5
[t][] [] [] [g][] [] []   [g][] [] [] [g]
[g][g][] [g][g][g][]   [g][g][g][] [g][g]
[g][g,s][g][g][g][g][g][g][g][g][g][g][g]
[g][g][] [g][g][g][]   [g][g][g][] [g][g]
[t][] [] [] [g][] [] []   [g][] [] [] [g]
